---------  --------       
|.......+##+....&.+#######
|...@...|  ------&-      #
|.......|       ---      #
|.$$....+################# 
---------                 
