---------  --------       
|.......+##+..&...+#######
|...@...|  ------.-      #
|.☼.....|       ---      #
|.$$....+#################
---------
