---------  --------       
|.......+##+..&...+#######
|...@...|  ------.-      #
|.......|       ---      #
|.$$....+#################
---------
